40 20
WWWWWWWWWWWWWWWWWWWWWWWWWWWWWWWWWWWWWWWW
W W      W W            W              W
W W WWW  W W WWWWWW WWWWW      WWWWWWWWW
W W   W  W W      W W          W   R   W
W WWWWW  W WWWWWWWW WWWWW      WWWWWWW W
W  W W   W                           W W
W HW W WWW     C                     W W
W  W W   W                       P   W W
W        W          G            WWWWW W
W                                      W
W                                WWWWW W
W        W                           W W
W  W W   W                           W W
WP W W WWW    B     S            V   W W
W  W W   W                     WWWWWWW W
W WWWWW  W WWWWWWWW WWWWW      W       W
W W   W  W W      W W          WWWWWWWWW
W W WWW  W W WWWWWW WWWWW          O   W
W W      W W            W    M         W
WWWWWWWWWWWWWWWWWWWWWWWWWWWWWWWWWWWWWWWW
