40 20
WWWWWWWWWWWWWWWWWWWWWWWWWWWWWWWWWWWWWWWW
W W      W W            W              W
W W WWW  W W WWWWWW WWWWW              W
W W   W  W W      W W                  W
W WWWWW  W WWWWWWWW WWWWW              W
W  W W   W                             W
W HW W WWW     C                       W
W  W W   W                             W
W        W          G                  W
W                                      W
W                                      W
W                                      W
W                                      W
W                                      W
W                                      W
W                                      W
W                                      W
W                                      W
W                                      W
WWWWWWWWWWWWWWWWWWWWWWWWWWWWWWWWWWWWWWWW
