40 20
WWWWWWWWWWWWWWWWWWWWWWWWWWWWWWWWWWWWWWWW
WC  W                              W  CW
WWW W    WW WW            WW WW    W WWW
WMW W    W  RW            W  RW    W WMW
W W W    WW WW            WW WW    W W W
W W W                              W W W
W                                      W
W WWW                              WWW W
WWW WWW     WWW          WWW     WWW WWW
WP          WBWWWWW  WWWWWBW          SW
WWWVWWW     W              W     WWWVWWW
W WWW       W WWWWWWWWWWWW W       WWW W
W                                      W
W W                                  W W
W WWWWWWWWW                  WWWWWWWWW W
W         W                  W         W
W WWW WWWOW                  WGWWW WWW W
W W WWW WWW                  WWW WWW W W
W W                H                 W W
WWWWWWWWWWWWWWWWWWWWWWWWWWWWWWWWWWWWWWWW
