40 20
WWWWWWWWWWWWWWWWWWWWWWWWWWWWWWWWWWWWWWWW
W R                                  R W
W   V  V  V                  V  V  V   W
WP                                    SW
WWWWWWWWWWWWWW            WWWWWWWWWWWWWW
WM           W            W           MW
WWWWWWWWWWWW W            W WWWWWWWWWWWW
W          W W            W W          W
W   W W    W W            W W     W W  W
W   W W    W W            W W     W W  W
W  CW W                          W WB  W
WWWWW WWWWW                  WWWWW WWWWW
W   W W   W                  W   W W   W
W W W W W W                  W W W W W W
W W W W W W                  W W W W W W
W W W W W W                  W W W W W W
W W WPW W W                  W W WCW W W 
W W WWW W W                  W W WWW W W
WGW     W          H           W     WOW
WWWWWWWWWWWWWWWWWWWWWWWWWWWWWWWWWWWWWWWW
