10 10
WWWWWWWWWW
W W      W
W W WWW  W
W W   W  W
W WWWWW  W
W  W W   W
W HW W WWW
W  W W   W
W        W
WWWWWWWWWW
